NO textures/path_to_the_east_texture.xpm
SO textures/path_to_the_north_texture.xpm
WE textures/path_to_the_south_texture.xpm
EA textures/path_to_the_west_texture.xpm

F 255,204,255
C 153,204,255

         11111111111111111111111
        1000000000110000000000001
        1011000001110000000000001
        1001000000000000000000001
11111111011000001110000000000001
1000000000110000011101111111111111111111111111
11110111111111011100000010000000000000000000001
11110111111111011101010010000000000000000000001
11000000110101011100000010000000000000000000001
10000000000000001100000010100100100100100100101
10000000000000001101010000000000000000000000001
11110111111111011101010010000000000000000000001
11000000110101011100000010000000000000000000001
10000000000000001100000010100100100100100100101
10000000000000001101010000000000000000000000001
11110111111111011101010010000000000000000000001
11000000110101011100000010000000000000000000001
10000000000000001100000010100100100100100100101
10000000000000001101010000000000000000000000001
11110111111111011101010010000000000000000000001
11000000110101011100000010000000000000000000001
10000000000000001100000010100100100100100100101
10000000000000001101010000000000000000000000001
11110111111111011101010010000000000000000000001
11000000110101011100000010000000000000000000001
10000000000000001100000010100100100100100100101
10000000000000001101010000000000000000000000001
11110111111111011101010010000000000000000000001
11000000110101011100000010000000000000000000001
10000000000000001100000010100100100100100100101
10000000000000001101010000000000000000000000001
11110111111111011101010010000000000000000000001
11000000110101011100000010000000000000000000001
1000000000000000110000001010111111111111111111
10000000000000001101010000001
11000001110101011111011110N0111
11110111 1110101 101111010001
 1111111 1111111 11111111111


 
